11111111111
10010000001
1PE00C01001
11000000111
11110000011
11111111111
