111111111
1E0000001
101P01001
111111111
